_____________________
_____________________
_____________________
_____#####_#####_____
_____#rr_###___#_____
_____#_c_#E#_c_#_____
___#####B#R#R#####___
___#_____________#___
___#bc_#D___S#_c_#___
___#####W_P_S#####___
___#~c_#W____#_c~#___
___#>_____c_____F#___
___######B#R######___
_______#__#__#_______
_______#_c#c_#_______
_______#_r#b_#_______
_______#######_______
_____________________
_____________________
_____________________
_____________________

